..........
.....nnn..
.nn....n..
..........
....nn....
.nn.......
..........